14,23
#######################
#s  # #   #         # #
### # # # # ##### # # #
# # # # # # #g#   #   #
# # # # # # # # ##### #
# # #   # #   #     # #
# # ##### ### ##### # #
#   #   #     # #   # #
# ### # ##### # # ### #
#     #     #   # # # #
########### ##### # # #
#                 #   #
#######################
