14,33
#################################
#s    #   #       #     # #     #
##### # # ##### # # ### # # # ###
#     # #       #   #g# #   #   #
# ##### ############# # # ##### #
#   # #   #       #     # #     #
### # # # # ### ### ##### # #####
# # # # # #   # #   #     #     #
# # # # # # ### # ############# #
#   #   # # #   #           #   #
# ####### # # ############# # # #
#         # #                 # #
#################################
